{
    "level 1": {
        "name": "Level 1",
        "map": [
            [99,99,99,99,99,99,99,99,99,99,99,99,99,99,99,99,99,99,99,99,99,99,99,99,99,99,99,99],
            [99, 1, 1, 1, 1, 1, 1, 1, 1, 1, 1, 1, 1,99,99, 1, 1, 1, 1, 1, 1, 1, 1, 1, 1, 1, 1,99],
            [99, 1,99,99,99,99, 1,99,99,99,99,99, 1,99,99, 1,99,99,99,99,99, 1,99,99,99,99, 1,99],
            [99, 2,99,99,99,99, 1,99,99,99,99,99, 1,99,99, 1,99,99,99,99,99, 1,99,99,99,99, 2,99],
            [99, 1,99,99,99,99, 1,99,99,99,99,99, 1,99,99, 1,99,99,99,99,99, 1,99,99,99,99, 1,99],
            [99, 1, 1, 1, 1, 1, 1, 1, 1, 1, 1, 1, 1, 1, 1, 1, 1, 1, 1, 1, 1, 1, 1, 1, 1, 1, 1,99],
            [99, 1,99,99,99,99, 1,99,99, 1,99,99,99,99,99,99,99,99, 1,99,99, 1,99,99,99,99, 1,99],
            [99, 1,99,99,99,99, 1,99,99, 1,99,99,99,99,99,99,99,99, 1,99,99, 1,99,99,99,99, 1,99],
            [99, 1, 1, 1, 1, 1, 1,99,99, 1, 1, 1, 1,99,99, 1, 1, 1, 1,99,99, 1, 1, 1, 1, 1, 1,99],
            [99,99,99,99,99,99, 1,99,99,99,99,99, 0,99,99, 0,99,99,99,99,99, 1,99,99,99,99,99,99],
            [99,99,99,99,99,99, 1,99,99,99,99,99, 0,99,99, 0,99,99,99,99,99, 1,99,99,99,99,99,99],
            [99,99,99,99,99,99, 1,99,99, 0, 0, 0, 0,21, 0, 0, 0, 0, 0,99,99, 1,99,99,99,99,99,99],
            [99,99,99,99,99,99, 1,99,99, 0,99,99,99,20,20,99,99,99, 0,99,99, 1,99,99,99,99,99,99],
            [99,99,99,99,99,99, 1,99,99, 0,99,99,99, 0, 0,99,99,99, 0,99,99, 1,99,99,99,99,99,99],
            [88, 0, 0, 0, 0, 0, 1, 0, 0, 0,99,99, 0, 0, 0, 0,99,99, 0, 0, 0, 1, 0, 0, 0, 0, 0,88],
            [99,99,99,99,99,99, 1,99,99, 0,99,99,22,23,24, 0,99,99, 0,99,99, 1,99,99,99,99,99,99],
            [99,99,99,99,99,99, 1,99,99, 0,99,99,99,99,99,99,99,99, 0,99,99, 1,99,99,99,99,99,99],
            [99,99,99,99,99,99, 1,99,99, 0,99,99,99,99,99,99,99,99, 0,99,99, 1,99,99,99,99,99,99],
            [99,99,99,99,99,99, 1,99,99, 0, 0, 0, 0, 0, 0, 0, 0, 0, 0,99,99, 1,99,99,99,99,99,99],
            [99,99,99,99,99,99, 1,99,99, 0,99,99,99,99,99,99,99,99, 0,99,99, 1,99,99,99,99,99,99],
            [99, 1, 1, 1, 1, 1, 1, 1, 1, 1, 1, 1, 1,99,99, 1, 1, 1, 1, 1, 1, 1, 1, 1, 1, 1, 1,99],
            [99, 1,99,99,99,99, 1,99,99,99,99,99, 1,99,99, 1,99,99,99,99,99, 1,99,99,99,99, 1,99],
            [99, 1,99,99,99,99, 1,99,99,99,99,99, 1,99,99, 1,99,99,99,99,99, 1,99,99,99,99, 1,99],
            [99, 2, 1, 1,99,99, 1, 1, 1, 1, 1, 1, 1,44, 0, 1, 1, 1, 1, 1, 1, 1,99,99, 1, 1, 2,99],
            [99,99,99, 1,99,99, 1,99,99, 1,99,99,99,99,99,99,99,99, 1,99,99, 1,99,99, 1,99,99,99],
            [99,99,99, 1,99,99, 1,99,99, 1,99,99,99,99,99,99,99,99, 1,99,99, 1,99,99, 1,99,99,99],
            [99, 1, 1, 1, 1, 1, 1,99,99, 1, 1, 1, 1,99,99, 1, 1, 1, 1,99,99, 1, 1, 1, 1, 1, 1,99],
            [99, 1,99,99,99,99,99,99,99,99,99,99, 1,99,99, 1,99,99,99,99,99,99,99,99,99,99, 1,99],
            [99, 1,99,99,99,99,99,99,99,99,99,99, 1,99,99, 1,99,99,99,99,99,99,99,99,99,99, 1,99],
            [99, 1, 1, 1, 1, 1, 1, 1, 1, 1, 1, 1, 1, 1, 1, 1, 1, 1, 1, 1, 1, 1, 1, 1, 1, 1, 1,99],
            [99,99,99,99,99,99,99,99,99,99,99,99,99,99,99,99,99,99,99,99,99,99,99,99,99,99,99,99]
        ],
        "homes": {
            "pacman" : [[23, 13]],
            "blinky" : [[1,1], [1,6], [5,5], [5,1]],
            "pinky" : [[1,21], [1,26], [5,26], [5,21]],
            "inky" : [[29,15], [29,26], [26,26], [26,21], [23,21], [20,21], [21,24], [18,23]],
            "clyde" : [[29,1], [29,12], [26,12], [26,9], [23,9], [23,6], [26,6], [26,1]]
        },
        "respawn": {
            "pacman" : [23, 13],
            "blinky" : [13,11],
            "pinky" : [13, 12],
            "inky" : [13, 12],
            "clyde" : [13, 12]
        }
    }
}
